20;
1;70;1;0;0;0;0;
2;80;2;0;0;0;0;
3;80;2;1;0;0;0;
4;80;2;1;0;1;0;
5;80;2;1;0;1;1;
6;80;2;1;0;1;1;
7;80;2;2;1;1;1;
8;80;2;2;1;1;1;
9;80;2;2;1;2;1;
10;85;3;2;1;2;2;
11;85;3;2;1;2;2;
12;85;3;2;1;2;2;
13;85;3;2;1;2;2;
14;85;2;2;1;2;1;
15;85;2;2;1;2;1;
16;85;2;3;1;3;1;
17;90;2;3;2;3;2;
18;90;2;3;2;3;2;
19;90;4;2;2;3;3;
20;85;4;2;2;3;4;
[LICZBA_POZIOMOW]
[POZIOM][WYPELNIENIE][LICZBA_WROGOW_WG_TYPU(ZWYKLY;DESTROYER;HUNTER;GUARD;SPECIAL)]